

    ------------
    |..........|
    |..........|       |--------------|
    |..........|       |..............|
    |..........#########..............|
    |..........|       |..............|
    |..........|       |..............|
    |..........|       |--------------|
    ------------

