

    +----------+
    |..........|
    |..........|       +--------------+
    |..........+-------+..............|
    |.................................|
    |..........+-------+..............|
    |..........|       |..............|
    |..........|       +--------------+
    +----------+

